1111111111
1000010001
1111000101
1001000101
1111111111
